3333333333333333333333333333334344444444444444444444444444444444444344433333333333333333333335333333
3333333333333333333333333333343244444444444444444444444242444444444444433333333333333333333333333333
3333333333333333333333333333344344444444444244444444444444444442442343433333333333333333333333333333
3333333333335333333333333333344443244444444444444444444444444444424334333333333333333333333333333333
3333333333333333335333333333344343444244444444444444444444444444443442333333333333333333333333333333
3333333333333333333333333333334424444444244444444444444444444444444344433333333333333333333333333335
3333333333333333333333333333334434444444444444444444444444444444443443433333333333333333333333333333
3333333333333333333333333333342444444444444444444444444442444444443443433333333333333333333333333333
3333333333333333333333333333344332444444444244444444444444444444444444433333333333333333333333333333
3333333333333333333333333333333333444444444444444444444444444444443434433333333333333333333333333333
3333333333333333353333333333344444444444444444444444444444444444424434433333333333333333333333333533
3333333333333333333333333333344444444444444444444444444442444444443434433333353333533333333333333333
3335333353333333333333333333333344444444444444444444444244444444444332433333333333333333333333333333
3333533333333333333333333333544343244444444444444444444444444444444344433333333333333333333333333333
3333333333333333333333333333344433444444444444444444444444444444445444333333333333333333333333333533
3333333333333333333333333333343244444444444444444444444444444444244442433333333333333335333333333333
3333333333333333333333533333344234444444444444444444444444444444442444333333333333333333333333333333
3333333333333533333333333333334434444444444444444444444444444444443334433333333333333333333333333333
3333333333333333333333333533323334444444444444444444444444444444444454433333333333333333333533333333
3333333333333335333333333333334334444444444444444444444424444444443433433333333333333333333333333333
3333333333333333333333333333343423444444444444444444444444444444444343433333333333333333333333333333
3333333333333333533333333533343353444444444444444444444444444444444444433333333333333333333333333353
3333333333333333333333333333343344444424444444444444424444444444444243433333333333333333333333333333
3333333333333333333333333333334444444444444444444442444444444444423244433333333333333333333333333333
3333333333333333333333333333533243424444444444444444444444442444442444333333333353333333333333333333
3333333333333333333333333533344444444444444444444444444424444444444443433333333333333333333333333333
3333333333333333533333333333344443442444444444444444444444444444442243333333333333333333333333333333
3333333333333333333333333333344334444444444444444444444442444444444424433333333333333333333333333333
3333533333333333333333333333333343424444442442424444444444444444444234333333333335333333333333333333
4343444344234444434353433442433434444444444444444444444444444444444442342433444433334434444443442334
3433444434433443444344444244444442442444444444444444444444444444444334324443344434334244424343433433
4333443544344344333334434344333343444444444444444444444444444424444334433344443343344443324444434444
3444344244423343443344443433344333444444444444442444444444444442443432433444443444424444444434344433
4444444444443234433444343432343444444444424444444444444444444444444333442343342433432434332324444244
4444444444444244444444444444444444444424444444444444444444442444444444444444444444444444444444444444
4444444444444424444444444444444444444444444444444444244444444444444444424444444444444444444444444444
4444444442444444444444444444444442444444442444444444444444444444444444444444444444444444444444444444
4444442444442444444444444444444444444444444444444444444424444444444444444444444444444444444444444444
4444244444444444444444444444444444244244444444444444444444444444444244444444424444444444444444444444
4444444444444444424444444444444444444424444444444444444444442442444444444444444444444424444444444444
4444444444444444444444444444444444444444444444444444444442244444424444444444424444442444444444444444
4444444444444244444444444444444444444444444444444444444444444444444444444444444444444444444444424444
4444444444444444444444424444444444444444444444444444444444442444444242444444444444444444444444444444
4444444444444424444444422444444444444444244444444444444444444244444444444444444444442444444444444444
4444444444444444444444444444444444444444444444444444444444444444424444444444444444444444444444444444
2444444444444444444444444444444444444444444444444244444444444444444444444444444444444444444444442444
4444444444444444244444444444444444244444424444444444444444444444444444244444444444444444444444444444
2444444444442444444242444444444444444444444444444444444444444442444444444444444424444444444444444442
4444444444444444444444444444444444444444444444444444444444444444444444424444444444444444244444444444
4424444444444244444444444444444244444444444444444444444444444444444424444444444444442444444444444444
4444442444444444444444444444444444444444444444444444444444444444444444444442424444444444444442444444
4444444444444444444424444444444424444444424444444444444444444444444444444444444424444444444444444444
4444444444444444444444444444444444444444444444444444444444444444444444444444444444244444444444444442
4444444444444444444444444444444444444444444444244444444444424444442444442442444444444444444444444424
4444444444444444444444444424444424444244444444444444444444444444244444444444444444444444444444444444
4444444444444444444444444444444442444424444444444444444444444444444444444444444444444444444444444444
4444444444444444444444444444444444424444444444444444444444444444444444444444444444444444444444444444
4444444444444444444444444444444444444444444444444444444444444444444444444444444444444444444444444422
4424444444244444444444444442444444444444444442444444444444444444444444444444444444444444444444444444
4444444444444444442444444444444244444444444444244444444444444444444444244444444244444444444444444444
4444224444444444444444444444444444444444444444444244444444424444444444444444444444444444444444444444
4444444444444444444444444444444444444444444444444424444444444444444444444444424444444444444444444244
4444444444444444444444444444444444444444444444224444444444444444444244444444444444444444444444444444
4444444444244444424444444244444444444444424444444444444444444444444444244444444444444444444444444444
4444444444444444444444444444244444444444444444444444444444444444444444444444444444444444444444444444
4444444444444444444424444444444444444444444444244444444444444444444444444444444444444444444444444444
4344334343444434344433433334444324444444444424444444444444442442444323343344334345434434433444442344
4344343344444444444334233433334443444444444444444224444444444442444334443444423444344444444423344334
4334334433323444434343434443444434444444444444444444424444244444444434234424434444434423443442433444
3443444432334443334444443434444443444444444444444444444444444444444433243243334434343443424444343443
4435432343334443433443444444344443444444444444444444442444444444444443244444432444444343433323334334
3333333333333333333333333333343334444444444444444444424444424424443453433333333333333333333333333333
5333333333333533333333333333333353442444444444444444444444444444443334333333333333333333333333333333
3333333333333333333333335333343532444444444444444444444444444444443443333333333333333333333353333333
3333333333333333333333333333332443444444444444444444444444444444444334333333333533333333335333333333
3333333333333333333333333333334444444444444444444444444444444444444433433333333333333333533333333333
3333333333333333333333333333343424444444444424444444444444444444444333433333333333333333333333333333
3333333333333333333333333333344334444424444444444444444444444444443343433333333333333333333333333335
3333333333333333333333333333333443444444444444444444444444444444443444333333333333333333333333333333
3333333333333333333333333333334333444444424444444244444444444444443343433333333333333333333333333333
3333333333333333333333333333344443444444444444444444444444444444443435433333333333333333333333333333
3333333333333333333333333333334344444444444444444444444444444444443443233333333333333333335333333335
3333333333333333333333333333343444444444444444444444444444444444444344333333333333333333333333333333
3333333333333333533333333333344344444444444444444444444444444444444344433333333333333333333333333333
3333333333333333333333333333333434444442444444442444442444444242443343233333333333333333333333333333
3333333333333333333333333333332443444444444444444444444444444444444343333333333333333333333333333333
3333333333333333333333333333344443444444444444444444444444444442443444433333333333533533333333333333
3333333333333333333333333333333334444444244444444444444444444444443443333333333333333333333333333333
3353333333333333353333333333344434444444444444444442444444444444444433433333333333333333333333333333
3333333333333333333333333333333434444444444444444442444444444444444424433333333333333333333333333333
3333333333333333333333333333343433444444444444444444444444444424444343433333333333333333333333333333
3333333333333333333333333333343443444444444444444444444444444444444344433333333333333533333333333333
3333333533333333333333333333343434444444424444444424444444444444443334333333333333333333333333333333
3333353333333333335333333333343244444444444444444444444444444444444343433333333333333333333333333333
3333333333333333333333333333333344444444444444444444444424444444443334433533333333333353333333333333
3333333333333333333333333333334433444444244444444444444444444444444433333333333333333333333333333333
3333333333333333333333333333343444444444444444444444444444444444444443433333333333333333333333333333
3333333333333333333333333333343444444444444444444444444444444444444343433333333333333333333533333333
3333333333333333333333333333323443444444444444444444444444444444443334433335333333333333333333333333
3333335333335333333333333333323343424444444444442444424444444424443334433333333333333533333333333333
