1111111111111111111111113113331333444444444444224444444444444444443331113113311131111111111111111111
1111111111111111111111111133111333444444444444444444444444244444443333133311333111111111111111111111
1111111111111111111111111133313313444444444444444444444444444444443313313511313111111111111111111111
1111111111111111111111111113313333444444444444444444424444444444443313333113111131111111111111111111
1111111111111111111113111333313333444444444444444444444444444444443331113131331311111111111111111111
1111111111111111111311311113331333444444444444444444444444444444443333311133111111111111111111111111
1111111111111111111111133111333133444444444444244444444444444444443333331111111111111111111111111111
1111111111111111111111111113333333444444444444444444444444444444243113333131111111111111111111111111
1111111111111111111113311313131313444442444444444444444444444444443333333133311111111111111111111111
1111111111111111111111113111133113444444442444244424444444444442443333113511311111111111111111111111
1111111111111111111111113133333333444444444444444444444444444444443313333313111111111111111111111111
1111111111111111111111311133311333444444444444444444444444444244443333133311111111111111111111111111
1111111111111111111111111133333333444444444444444444444444444444243113333111333111111111111111111111
1111111111111111111111111131313333444444444444244444444444444444443313133131111111111111111111111111
1111111111111111111111113133313333444442444244444444444424444444443333133311311111111111111111111111
1111111111111111111111111333333333444444444444444444444444444444445331311331331111111111111111111111
1111111111111111111113111133333133442444424444444444444444444444243333331333111111111111111111111111
1111111111111111111111111133333333444444444444444444444444424442443333331313311111111111111111111111
1111111111111111111131313333113313444444444444442444444424444444441333333511111111111111111111111111
1111311111111111111113311111331153444444444444444444444444444444443331131111331131111111111111311111
1111131111113131131111113333313331444444444444444444444444444444443333133333131111111111131113111311
1113113111111111311111331331313535444444444444444444444444444444443331355333111331111111111131111111
1311131111131111111111111133333333444444442444444444444444444444443333333313333313311131111111311311
3113333131111111313311333131331333444444244444444444444444444444423333353313311313111351133111115333
1111331311111113111113113333333333444444444444442444444444444444443333331331311311111311311131131113
1331311131331131311311331333331135444444444444444444444444444444443331333333131131113111113131111153
3311113131331331333133133313133333444444444444444244444444444444443531333131313133113133131333331311
1313133133333313333113513133333333444442444444444444444444444444443131313333313331333333133311313331
5111131311333333333131133333333333444442444444444444444444444444443333313113333331311311133133131331
3113333311313131333313333333333333444444444444444444444424444444443133333313333311333331131331333331
3333133333333311115113333331333333444444444444444444444444244444443333331333333313133331131131331313
3333333333333333333333333333333333444444444444424424244444444444443333333333333333133333333331331333
5313133333333333333333133133333333444444444444444444444444444444443333333311333333333331313333333333
3333335333335333333333333333333333424444444444444444444444444444443333333333333333333333333333333333
4444444444444444444444442444444444444444444444444444244244444444444444444444444244444444444442444444
4444444444444444444444444444444444424444444444444444444444444444444444444444444444444444444444444444
4444444442444444444444444444444444444444444244444444444444444442444444444444444444444444444444442444
4444444444444444442444444444444444444244444444444444444444444444444444444444444444444444444444444444
4444444444444244444244444444444444444444224444444444444444444444444444444444444444444424444444444444
4444444444444444444442444444444444444444444444444444442444444444444444444442444444444444444444444424
4444444424444444444444444444444444444444444444444444444442444244444444444444444444444444444444444444
4444424444444444444444444444444444444444444444444424444444244444444444444444444444444444444444442444
4424244444444444444444444444444444444424444444444444444444444444444444444444444444444444444444444444
4444424444444444444444444444444444444444444444444444444424444444444444444444424444444444444444444444
2444444444444444442444444444444444444444444444444444244444442444444444444444442444444444444444444444
4444444244444444444444444444444444444444444444444444444444444424444444444444444444444444444444444444
4444444444444444444444444444444442444444444444444444444444444444444444444444444444444444444444444444
4442444444444444444444424444444442444444444444444444444444444442444444444444444444444444444444424442
4444444444444422444444444444444444444444444444424444444444444444444444444444444444444444444444444444
4444444424444444424444444444444444444444444444444444444424444444444244444422444444444444444444444444
4444444444444444442444444444444444442444444444444442444444442444444444444444444444444444444444444444
4444444444444444444444444424442444444444444444244424444444444424442444424444444444444444444444444444
4444444444444444444244444444444444444444444444444444444444444444444444444444424444444444444442444444
4444444444444444444444444444444444444444444444244444444444444444444444444444444444444444442444444444
4444444444444444444444444444444442444444444444444444444444444444244424444444444444444444424444444444
4444444444444444444444444444444444444424444444444444444444444444444442444444444444444444444444444444
4424444444444444444444424444444444442424444444444444444444444444444444444444444444444444444444444444
2424444444444444444444444424444444444442444444444444444444444444244444444444444444444444424424444444
4444444444444444444444444444444444444444444444444444442444444444444444424444444444444424444444444444
4444444444442444424244444444444444424444444444444444444444444444444444444444444444444424444444444444
4444444444444444444444444444442444444444444444444444244244444444444444444444444444444444444444444444
4444444444444444444444442444444444444444444444444444444444444444444444444444444444444444444444444444
4444444444444444444444444444244444444444444444244444444444444444444444424444444444444444444442444444
4444444444444444444444424444442444444444444444444444444444444444444444444444444444444444444444444444
4444444444444444444444444444444424444444444444444444244444442442444444244444444444444444444444444444
4444444444424444444444444444444444444444444444444444442444444444444444444444444444444444444444444444
3333333333533331333333333333333333444444444444444444444444444444443333333333333333333333333313333333
3333331333333333333133333313331333444444444444444444444444444444443333333333133333333333333333333333
1333333133333313333333333333331333444444444444444444444444444444443333333333331313333133313133133333
3333333333133113333333333313533333444444444444444444444444444444443333333133331133331313113331333113
5333111313333111133333331313133333444444444444444444444444444444443333333333333333313333113331313111
1331111131331133133133133333333333444444442444444444444444444444443333333331311115113311313311333311
1331131333313133311331113333313333424444444444444444444444444444443333333311111311133313331131113131
3331311111131113311113333133333133444444444444444444444442444442443331333333313331111331333313333313
1331331113331333111111133111333333444444444444442444444444444444443333113331131313111313331313333111
3113311333331131331113333313133333444444444444444444444444444444443313111313111311113113113111313313
1111111111311113333311333133333333444444444444444444444444444444443333313131111333313331131111131111
3131331133111331313111333133333313444444444444444444444444444444443333333331111331133131133131331131
3113111111111111111113131113335333444244444444444444244444444444443333353313311111111311311131331131
1311131111111111131111133331333333424444444444444444444444444444443331313333131111113111311311111131
1111111111111111111133113331335313444444444444444444444444444442443331333111113311311113111111111111
1111111111111111111111111131133133444444444444444444444444444444443131111111313311111111111111111111
1111111111111111111113111331333333444444444444444444444444444444443333311311111111111111111111111111
1111111111111111111111111113133133424444444444444444444444444444443333111131111111111111111111111111
1111111111111111111133113131311333444442444444444444444444244424443111331331111111111111111111111111
1111111111111111111111111313133131244444444444424444444444444444443133333331111111111111111111111111
1111111111111111111111111113333333444444444444444444444444444444443333313151111311111111111111111111
1111111111111111111131313133333331444444444444444244444444444444443331333333113111111111111111111111
1111111111111111111113131131333333444444442444444444444444444444443333131113113111111111111111111111
1111111111111111111113111311133333444444444444444444444444444444443333313313111111111111111111111111
1111111111111111111113113331113333444444444444442424444444444424441131113113111111111111111111111111
1111111111111111111111111313313333424444444444444444444444444444443333133333111311111111111111111111
1111111111111111111111111111131333442442444444444444444444224444443333333313113111111111111111111111
1111111111111111111111311111333333444424444444444444444444444444443331333111131311111111111111111111
1111111111111111111133111333333333444444444444444444444444444444443153331311111111111111111111111111
1111111111111111111131311111333333444444444444442444444444444244443131131331111111111111111111111111
1111111111111111111111131113133333444444444444444444444444444444443333331311311111111111111111111111
1111111111111111111111111331333333444444444444444444444444444442443333133333111111111111111111111111
1111111111111111111111111333131131444444444444444444444444444444443333331131113111111111111111111111
1111111111111111111113111313131113444444444444424424442444444424443333113131311111111111111111111111
