1101111111111111111001111111033333222222222222222222222222222222223333311111111111111111011111111111
1111110111111111110111111101133333222222222222222222222222222222223333310111111111111110111111110111
1111111111111111011111111111133333222222222222222222222222222222223333311111101111111111111110101101
1111111111111011111111111111133333222222222222222222222222222222223333311111111111101111111111111111
1111111111011111111101010011133333222222222222222222222222222222223333311011101111101111111001111111
1111101111111111111111111111133333222222222222222222222222222222223333301111111100111111110111111111
1111111111111110111011011111133333222222222222222222222222222222223333311111011111111011111110111111
1111111111111111111111111110133333222222222222222222222222222222223333311111111111111111011111110111
1111101111101111111111111110133333222222222222222222222222222222223333310011111111101111111111111011
1011110011111111101111111111133333222222222222222222222222222222223333311011111111111111011111111111
1101111111111111111111111111133333222222222222222222222222222222223333311111110111111111111111111011
1111010011111111100111111111133333222222222222222222222222222222223333311111101111111101110111111011
1110111011111111111111111111133333222222222222222222222222222222223333311110111011111111101110111111
1110111111111111111010111111133333222222222222222222222222222222223333311111111111101111111110111111
1111011101111111011111111111133333222222222222222222222222222222223333311111001111111111101011111111
1111111111110111111111111111133333222222222222222222222222222222223333311111111111111111111011111111
1111111011111111111110111111133333222222222222222222222222222222223333311111111110011111010101111111
0110110111111111111101111011133333222222222222222222222222222222223333311011111011111111111111111111
1111111110111111111111110111133333222222222222222222222222222222223333311111111111111111111111111111
1111011011111111111111111111133333222222222222222222222222222222223333311111111111111011111111111111
1111101111110111110111011111133333222222222222222222222222222222223333311111111111111011111111111111
1111111111111111111111111111133333222222222222222222222222222222223333311111111111111111111111010101
1111111111111111111111111111133333222222222222222222222222222222223333311111111111111111111011011111
0101111101011111111111111111033333222222222222222222222222222222223333311011111111111111010111111011
1111111111111111111110011111133333222222222222222222222222222222223333311111111111111110111111111111
1110111101111111111111111111133333222222222222222222222222222222223333311111011111111111111111111111
0111111111111111111111111111133333222222222222222222222222222222223333311101111101111111111111111101
0011101111111100101110110111133333222222222222222222222222222222223333310111110111111011111111111111
1111111111101111011011101111133333222222222222222222222222222222223333310111111111110111101111111111
3333333333333333333333333333333333222222222222222222222222222222223333333333333333333333333333333333
3333333333333333333333333333333333222222222222222222222222222222223333333333333333333333333333333333
3333333333333333333333333333333333222222222222222222222222222222223333333333333333333333333333333333
3333333333333333333333333333333333222222222222222222222222222222223333333333333333333333333333333333
3333333333333333333333333333333333222222222222222222222222222222223333333333333333333333333333333333
2222222222222222222222222222222222222222222222222222222222222222222222222222222222222222222222222222
2222222222222222222222222222222222222222222222222222222222222222222222222222222222222222222222222222
2222222222222222222222222222222222222222222222222222222222222222222222222222222222222222222222222222
2222222222222222222222222222222222222222222222222222222222222222222222222222222222222222222222222222
2222222222222222222222222222222222222222222222222222222222222222222222222222222222222222222222222222
2222222222222222222222222222222222222222222222222222222222222222222222222222222222222222222222222222
2222222222222222222222222222222222222222222222222222222222222222222222222222222222222222222222222222
2222222222222222222222222222222222222222222222222222222222222222222222222222222222222222222222222222
2222222222222222222222222222222222222222222222222222222222222222222222222222222222222222222222222222
2222222222222222222222222222222222222222222222222222222222222222222222222222222222222222222222222222
2222222222222222222222222222222222222222222222222222222222222222222222222222222222222222222222222222
2222222222222222222222222222222222222222222222222222222222222222222222222222222222222222222222222222
2222222222222222222222222222222222222222222222222222222222222222222222222222222222222222222222222222
2222222222222222222222222222222222222222222222222222222222222222222222222222222222222222222222222222
2222222222222222222222222222222222222222222222222222222222222222222222222222222222222222222222222222
2222222222222222222222222222222222222222222222222222222222222222222222222222222222222222222222222222
2222222222222222222222222222222222222222222222222222222222222222222222222222222222222222222222222222
2222222222222222222222222222222222222222222222222222222222222222222222222222222222222222222222222222
2222222222222222222222222222222222222222222222222222222222222222222222222222222222222222222222222222
2222222222222222222222222222222222222222222222222222222222222222222222222222222222222222222222222222
2222222222222222222222222222222222222222222222222222222222222222222222222222222222222222222222222222
2222222222222222222222222222222222222222222222222222222222222222222222222222222222222222222222222222
2222222222222222222222222222222222222222222222222222222222222222222222222222222222222222222222222222
2222222222222222222222222222222222222222222222222222222222222222222222222222222222222222222222222222
2222222222222222222222222222222222222222222222222222222222222222222222222222222222222222222222222222
2222222222222222222222222222222222222222222222222222222222222222222222222222222222222222222222222222
2222222222222222222222222222222222222222222222222222222222222222222222222222222222222222222222222222
2222222222222222222222222222222222222222222222222222222222222222222222222222222222222222222222222222
2222222222222222222222222222222222222222222222222222222222222222222222222222222222222222222222222222
2222222222222222222222222222222222222222222222222222222222222222222222222222222222222222222222222222
2222222222222222222222222222222222222222222222222222222222222222222222222222222222222222222222222222
2222222222222222222222222222222222222222222222222222222222222222222222222222222222222222222222222222
3333333333333333333333333333333333222222222222222222222222222222223333333333333333333333333333333333
3333333333333333333333333333333333222222222222222222222222222222223333333333333333333333333333333333
3333333333333333333333333333333333222222222222222222222222222222223333333333333333333333333333333333
3333333333333333333333333333333333222222222222222222222222222222223333333333333333333333333333333333
3333333333333333333333333333333333222222222222222222222222222222223333333333333333333333333333333333
1110111111111111111111111101133333222222222222222222222222222222223333311111110110111111111111111111
1101101111111111101111111101133333222222222222222222222222222222223333310111110111111011111100111111
1111010111101111111111111111133333222222222222222222222222222222223333311111111111111111111111111111
1111111111111111101111110110133333222222222222222222222222222222223333311111111101101111111111101101
1111111111111101011111111110133333222222222222222222222222222222223333311111111111011111111111111010
1111111110101111111110011101133333222222222222222222222222222222223333311111111011111111011111111011
1111111111110111111011111111133333222222222222222222222222222222223333311111111111111111111111111111
0111111011011111111110111111133333222222222222222222222222222222223333311111111101111011101101111111
1111111111111111111111110111133333222222222222222222222222222222223333311101011111111111001111111111
1111111111111111110111111111133333222222222222222222222222222222223333311111111111111111111111111101
1110101111011110111111111111133333222222222222222222222222222222223333311111111011110111101011111111
0111111111111111111111111001133333222222222222222222222222222222223333311111111111111011111111111111
1110111111111111101111101101133333222222222222222222222222222222223333311110111111111111101111111111
1010111111111111111111111111133333222222222222222222222222222222223333311111011111111110111111111111
1111111011100111011111111101133333222222222222222222222222222222223333310110011011111111111111011111
1111101111111111111111111111133333222222222222222222222222222222223333311111011011111111111111111111
1111111111111011111111111111133333222222222222222222222222222222223333311111110110111111111011110111
1111111111111011111111111111133333222222222222222222222222222222223333311110110111111111111111111111
0111110111111111110111111111133333222222222222222222222222222222223333311111111111111111111111011111
1110111101110111111111101111133333222222222222222222222222222222223333301001001110111111111111111011
1101111111111111111111111111133333222222222222222222222222222222223333311100111111111111111111111111
1111111111111111111111111011133333222222222222222222222222222222223333311111111111111110111111111101
1011101111101111111111111111133333222222222222222222222222222222223333301111111101111111111110111101
1111111111111111101111111111133333222222222222222222222222222222223333311111111111111111111111101110
1111110111111111111110111111133333222222222222222222222222222222223333311111111111111110111111111111
1111011111011111111111111111133333222222222222222222222222222222223333311111111101111111111111111111
1101101111110011111110111111133333222222222222222222222222222222223333311111110111111111110111101111
1111111111111111111111111101133333222222222222222222222222222222223333311110111101111110011101111111
1110111011111111111111111111133333222222222222222222222222222222223333311111111110111011101111011111
