1111111111111111111111113111133133444444442444444444444444244424443331331331331111111111111111111111
1111111111111111111131313311113333444444444444444444444442444244443333333131111111111111111111111111
1111111111111111111311111353331333444444444444444444444444444444443333331111111111111111111111111111
1111111111111111111113311331133133444444444444444444444444444444443333331131311111111111111111111111
1111111111111111111113311313133333444444444444444444444444444444443333311311111111111111111111111111
1111111111111111111111131133331313444444444444444444444444444444443333133331113111111111111111111111
1111111111111111111111113113111333444444444444444442444444444444443133331311111111111111111111111111
1111111111111111111111111133133333444444444444444444444444444444441333133333313111111111111111111111
1111111111111111111131131311313333444444444444444444244444444442423333331111311111111111111111111111
1111111111111111111111131131333333444242444444444444424444444444443333333313131331111111111111111111
1111111111111111111311131133331311444444444444444444444444444444443333311313111111111111111111111111
1111111111111111111133311111133133444444444444444444424444424444443313333111111111111111111111111111
1111111111111111111113115311331133444444444444444444444444444444443331333113331111111111111111111111
1111111111111111111111131313333313444444444444444444444444444444443333311311111111111111111111111111
1111111111111111111313111131133333444442444244444444444424444444443331513133113111111111111111111111
1111111111111111111311131131333333442444444444444444444444444444243311131111111111111111111111111111
1111111111111111111111131111111133444424444444444444444444444444443133311333113111111111111111111111
1111111111111111111111311333333333444442444444444444444444244444443333311331111311111111111111111111
1111111111111111111111113113135333444444444444444444424444444444443313333313311111111111111111111111
1111131111111111111111111133333313444444444444444444444444444444443313311313313311111111113113111111
1111111131113111111113311333333333444444444444444444444444244424443333333111113311111111111111331113
1111111331311311111113133113333333442444444444444444444444444444443333333311111131311133111111111131
3111111111331311133131133111331333444444444444444444444444444444443133111333311111111331113111111113
1111113331111131111131331513331133444444444444444444444444444444443333333131533331111331131131133311
3313313311131311311113131333331333444444444444444444442444444444441333133113331313311133313113131111
1113311111311111311331133313333333444444444444444444444424444444443333333333331133313113113133111131
1311131331313311111113333313331313444444424444444444444444444444243333333313131333111351333111131111
3111111113331131311333333333333333444444444444244444444224444444445313333151313333353333111331331313
3133313131313311313333311313331333444444444444444444444444444444443333333333131313133313331333133313
3331313133133313333333133333333133444444444444444444444444444444443333333331333133331311331133311311
5331311113113313313133313313333353444444244444444444444444444444443333133333313333133131133133131333
3331353111333333331333333333333333424444444444444444444444444444443335331333331333333331313133331333
1333333131333333333333333333333335444444444444444444444444444444443333133333333335331333333333133333
3133133333333133333333333333335331444444444444444444444444444444243333331333333333333333333333333335
4444444444444444444444444444442444444444444444444444444444444244444444444244444444444444444444444444
4444444444444442444444444444444444444444444444444444444444444442444424444444444444442444444444444444
4444444444242444444444444444444444444444444444444444444244444224444444244444444444444444424444444444
4444444444444444444444444444444444444444444444424444444444444444444444444244444444444444444444444444
4444424444444444444444444444444444444444444424444444444444444424444444444444444444444444444444444444
4444444444444444444444444444444444444444444444444444444444444444444444444444444444444444244444244444
4444444444444444444444444444444444444444444444444444444244444444444444444444444444444444444444444444
4444444444444444444444444444424444444444444444444444444444444442444244444444444244444444444244444444
4444444444444444444424444444444444444444444444444444444444444444444444444444444444444442444444444444
4444444424444444424444444444444444444444444444444444444444444444244444444444444444444442444444444444
4444442444444444444444444424444444444444444444424444444444444444444444444444444444444444444244444444
4442444444444442444444444444444444442444444244244444444244444444444444442244444444444444444444444444
4444444444444444444444444444444444444442444444244444444444444444444444444444444444444444444444444442
4444444444444444444444444444444424444444444444444444444442424444444444444444442444444444444444444444
4444444244444444444444444444444444444444444442444444444444444444444444442444444444444444444444444444
4444444444444444444444444444444444444444444444244444444444444444444444444444444444442444444444444444
4424444444444444444444444444444444424444444244444444444444444444444444444444424444444424444444444444
4444444444444444444444444444444444444442444424444444444444444444444424444444444444444244444444444444
4424444444444444444444444442444444444444444444442244444444444444444444444444444444444444444444444444
4444444444444444444444444444444444444444444444444444442444444444444444444444444444244444444444444444
4444444444444444444444424444444424444444444444444444444444444444444444444444444444444444444444444444
4444444444444444444444244444444444444444444444444444444444444444444444444444444444444444442444444444
4444444444444444444444444444444444444444444444444444444442444444424444444444444444444444444444444444
4444444444444444444444444442444444444444444444444444444444444444444444444444444444444444444444444444
4444444444444444444444444424444444444444444444444444444444444444444444444444444444444444444444424444
4444444424444444444444444444444444444444444444444444424424444444444444444444442444444444444444444444
4444444444442444444444444444444444444444444444444444444444444444444444444244444444444444444444444444
4444444444444444444444444444424444444424444444444444444444444424424444444444444444444244444444444444
4444444444444444444444444444444444444444424444444444444444424444444444444442444444444444444444444444
4444442444444444444444444444444444444444444444444444444444444444444444444444444444444444444244444444
4444444444444444444444444444444244444442444424444444444424444444444444444444444444444444444444444444
4444444444444444444444444444444244444444244444444444444444444444444444444444444444444244444444444444
3333333333331333333333333333333333444444444444444444444444244444443333333333333313333333333333333333
3333333133333333333331333333333333444444444444444444444444444444443333133333333333313333133333333331
3333333333333133333331333333133333444444444444444444444444444444443333333333133333333333133331333333
3333331133333331113333313133333333444444444444444444444444444444443331333333331333511133333131333131
3311331331313333133113131133353315444444444444444444444444444244443333353313133333133311333113313113
3311353311113313131331313333333333444444444444442442444444444444443333333333333533313311311131113333
1331331311111311133133331333333333424444444444444444444444444444443333133333311131111333313313313131
1111313131311111311333333133333331444444444444444444444444444444443333331313331331331111113131333131
1113331133313333313133333333313133444244444444444444444444444444443333331311333313113131113131313333
1111311311111331133113133133333333442444442444444444444444444444443533333113331111131133313331111111
3311113113311131113111131133131333442444444444444444444444444444443333333131331111311111111331111111
1131313111111313311331111131333333444444244444244444444444444444443133311131311111113113311111311311
1111111111113111111111331113333333444244444444444444444444444444441333111131111311111113131111131113
1113111131111111111113331313153333444444444244444444444444444444441133333131331111111111111113111111
1111311111131111131111111131131333444424444444444444444444444444443331113333311111111111111111131111
1111111111111111111111131113313333244444444444444444444442444444443111133311333111111111111111111111
1111111111111111111111131131333333444444444444444444444444444244443333333113311111111111111111111111
1111111111111111111131151333133333444442444444444444444444444444443331133111111111111111111111111111
1111111111111111111111113311333333444424444444444444444444444444443313133313111111111111111111111111
1111111111111111111111311313333133444444444444444444444444444444443333333133315111111111111111111111
1111111111111111111111313131333133442444444444444444444424444444443331333331331111111111111111111111
1111111111111111111111131331331131444444444444444444444444444444443331313311111111111111111111111111
1111111111111111111111111331313333444444444444444444444444444444443333311113111111111111111111111111
1111111111111111111113111333313333444444444444444444444424444444443311333131113111111111111111111111
1111111111111111111111111313133333444444444444444444444444444444443333331133111311111111111111111111
1111111111111111111111331313113333442444444444444444444444444444443333133311111111111111111111111111
1111111111111111111131131111333331444444444444444444444444444444443333133311311131111111111111111111
1111111111111111111133111331113333444444244444444444444444444444443333133333331111111111111111111111
1111111111111111111311113333313333444444424444444444444444444444443333111311111131111111111111111111
1111111111111111111311131111131313444444444444444444244444444424443133313313111311111111111111111111
1111111111111111111111111311313333444444444444444444444444444442443331311331111111111111111111111111
1111111111111111111111111113333333444444444444444444444444442442443333311331311111111111111111111111
1111111111111111111113113311331333444442444444444444444444444244443333313313311111111111111111111111
1111111111111111111111311131133313444444444444444444444444444444441331333313111131111111111111111111
