3333333333333333333333333333344344444444444444444444444424444444444434433333333333333333333333335333
3333333333333333335333333333323444444444424444444444444444444444443434433333333333333333333353333333
3533333333333333333333333333344244444444444444444244444444444424444344333333333333333333333333333333
3333333333333333333333333333344443424444444444444444444244444444443334353333333333333333333333333333
3333333353333333333353333333343343444444444444444444444444444444244343333333333333333333333333333333
3333333333333333353333333333344334444444444444444444444444444442443444433333333333333333333333333333
3333333333353333333333333333332443444442444444444444444444444444444343333333533333333335333333333333
3333333333333333333333333333334424444444442444444444444444444244444443333335333333333333333333333333
3533333333333333333333333333334443444444444444444444444444444444443444335333333333333333333333333333
3333333333333333333333333333343344444444444444444444444444444444443343433333333333333333333333333333
3333333333333333333333333333334243444444424444444444444444444444443434433333333333333333333333333333
3333333333333333533333333333334433444444444444444444444424444444444333433333333333333333333333333333
3333333333333333333333333333343434444444444444444444444444444444444444433333333333333333333333333333
3333333333333333333333333333344433444444444444444424444444444444444343333333333333333333333333333333
3333333333333333333333333333345434444444444444444444444444444444444433433335333333333333333533333333
3333333333333333333333333353343234444444444444444444444444444444443443433333333333333333333333333333
3333333333333333333333333333332344444444444444444444444444444444445343433333333333333333333333333333
3333333333333333333333333333344424444444442444444244444444444424423432333333333333333333333333333333
3333333333333333333333333333344324444444444444444444444444444444444444333333333333533333333333333533
3333335333333333333333333333334523444444444444444444444444444444444444433333333333333333333333333333
3333353333333333333333333333334434444444444444444444444444244444444444333333333333333333333333335333
3333333333333333333333333333343243444444444444444444444444444444444442433333333333333333335333333333
3533333333333335333333333333334444444444444444444444444444444444444434433333333333333333333333333333
3333333333333333333333333333344344444444444444444444444444444444444443333333335333333333333333333333
3333333333333333333333333333343434444444444444444444444444444444424442233333333333333333333333333333
3333333333333333333333333333333432444444444444444444444444444444444442333333333333333333333333333333
3333333333333333333333335333333334444444444444444444444444444444443333433333333333333333333333333333
3333333333333333353333333333333344444444444444444444444444444444444244333333333333333333333335333533
3533333333333333333333333333334343444444444444444444444444424444444443233333333333333333333333333333
4334443333343333434344444244434433444444444424444444444444444444443333334343444444334433444434434434
4434443344443344443344442234433433444444444444444444444444444444444443424334424444443434432432543444
2444454344243344334342444444433423444444444444444444444444444444444343443344354443244333433342443243
3444443434333344444433343344433432444444444444444444444442444444444343443344243342424444333344433433
3244444443434334444332344443443334444444444444444444444444444444444443433232444343344444344344244434
4444444444444442444444444444444444424444444444444442444444444444444444424444444444444444444444444444
4444444444444444444444444424444444444444444444444444444444244444444444444444444444444444444444444444
4444424444444444444444444444444444444444444444444444444444444444444444444444444444444444424444444444
4244444444424444444444444444444444444444444444424444444444442444444444444444444444444444444444444444
4444444444244444442444444424444444444444444444444444444244444444444444444444444444444444444244444444
4444444444444444444444444244444444444444444424444444444444444444444444244444442444444444444444444444
4444444444444444444444444244444424444444444444444444442444444444444444444444444444444444444444444444
4424444444444444444444444444444444444444444444444444444444444444444444444444444444444444444444444444
4444244424444444444444444444444444444444444444444442444444424444444444444244444444444444444444444444
4444244444444444244444444444444444444444444444444444444444444444244244442444444444444444444444444442
4444444242444444444444444444444444444444444444444444444444444444444444444444444444444444444444444444
4444444444444444444444444442444444444444424444444444444444444444444444444444444444444444444444444444
4444444444444444444444444444444444444444444444444444444444444444444444444444444444444444444444444444
4444444444444444444444444444444444444444444444444444444444444444444442444444444444444444444444444444
4444444444444444444444444444444444444444444444444444444444444444444444444444444444444444444444444444
4444444444444444444444444444444424444444444444444444444444444444444444444442444444444444444444442444
4444444444444444444424444444444424444444444444444444444444444444444444444444444444444444444444444444
4442444444444444444444444444444444444444444444444444444444444444444444444444444444444444444444444444
4444444444444444442444444444444444444444444442444444444444444444444444444444444444424424444444424244
4444444444244444444444444444444444442444444444444424444442444444444444444444444444444444424444444444
4444444444444444444444444444444444444444444444444444444444444444444444444444444444444444444424244444
2444444444444444444444444444444444444424444444442444442444444444444244444444244444444444444444444444
4444444444444444444444444444244444244444444444444444444444444444444444444444424444444444444444444444
4444444444444444444444444444444444444244444444444444444444444444444244444444444244444444444444444442
4444444424244442444444444444444444444444444444444444444444444444444444444444244444444444444444444444
4244444444444244444444444444444444444444444444444444444444444444444444444444444444444444444444224444
4444444444444444444444444444444444444444444444444444444444444442444444444444444444444444444444444444
4444444444444444444444444444444442444444444444244444444444444424444444444444444444444444444444444444
2444444444444444444444444444444444444444424444444444444244444444444444444444444444444444444444444444
4444444444444444444444444424244444444444444444442444444444444444444224444444244444444444444444444444
4444444424442444244444444444424444244444444444444444444444444442444444444444444444442444444444444444
4444444424444424244444444444444444444444444444444444444444444444444244444444444444444444444444444444
3433444344434444443243434323433434444444444444424444444444444444443434444443233343442434233443442444
4334344344444324444443244443223442444444444444444444444244444444442224443343424344344444444444442444
3434343433344433344333234333333344444444444424444424444444444444443424443443233444434433334333333444
4444433443434424444442343444443444444444444444444444444444444244444333433344444444343443432444434444
3444332344244444333433434344444443444444444444444444444444444444443444444344443443443454444444444444
3353333333333333333333333333344444444444444444442444444444424444444333433333333333333333333333333333
3533333333333333333333333333344332444444424444444444444444444444443334333333333333333333333333333333
3333333333333333333333333333344424444444444244444444244444444444444434333333333333333333333333333333
3333333333333333333333333533344343444444444444444444444444444444444444333333333333333333333333333333
3333333333333333333333333353534335444444444444444444244444444444444443333333333333333333333333333333
3333333333333333533333333333343434444444444442444442444444444444444333333333333333333333333333333333
3333333533353333333333333333333344444444444444444444444444444424444244433333333333333333333333333333
5333333333333335333533333333344444444444444444444444444444444444444343433333353333333333333333333333
3533533533333333333333333333344444444444444444444444444444444442443434333333333333333333333333333333
3353333333333333333333333333333433444444444444444444444444444444444444433333333533333333333333333333
3333333333333333333333333333344234444444444444444444444444444444444324433333333333333333333333533333
3333333333333333333333333333334433444444444444444444444444424444443444433333333333333333533333353333
3333333333333333333333333333343443424444444444444444444444444444443444433333333333333333333333333333
3333333333333333333353333333344324442444444444444444444244444444444334433333333333333353333353333333
3333333333333333333333333333344434444444444444444444444444444444444444433333333333333333333333333333
3333333333333333333333333333344534444444444444444444444444444444444444433333333333333333333333333335
3333333333333333333333333333344434444424444444444444444444444444444343333333333333333333333333333333
3333333333333333333333333333324434444444444444444444444444444444444334333333333333333333353533333333
3333333333333333333333333353343444444444444444442444444444444444443454333333333333333333333333353333
3333333333333333333333333333344344444424444444444444444444444444444343433333333333333333333333333333
3333333333333333333333333333324444444444422444444444424444444444444443433333333333333333333333335333
3333333333333333333333333333334334444444444444444444444444444444444333433333333333333333333333333333
3333333333333333333333333333334444444244444444444444444444442444444343433333333333333333333333333333
3333333333333333333333333333344344444444444444442444444444444444444434533333333333333333333333333333
3333333333333333333333333333334343444444444444444444444444444444444342433333333333333333333333333333
3333333333333333333333333333342344442444442444444444444444444444443343433533333333333333333333333533
3333333553335333333333333333324334444444444444444444444444444444444344333333333333333333333333333333
3333333333333333333333333333334343244444444444444444444444444444444344333533333333333333333333333533
3333333333333333333333333333333334444444444444444444444444444444443444333333333333333333333333333333
